Powerful Tabi Staff: Tabi Staff
Powerful Fwell Sword: Fwell Sword
Cape S'loque: S'loque Cape
Wand Else: Wand Else?
Captain Pirate's Cloak: Pirate Captain’s Cloak
Vampyre Cloak: Vampire Cloak
Powerful Knight Sword: Knight Sword
Powerful Bwork Blade: Bwork Blade
Powerful Concentration Boots: Concentration Boots
Powerful Dagguise: Dasguised
Powerful Chase Boots: Chase Boots
Klime's Powerful Boots: Klime's Boots
Hypnotic Deceitful Daggers: Deceitful Daggers
Magnificent Sleeping Shovel: Sleeping Shovel
Powerful Mishmashovel: Mishmashovel
Koutoulou's Frightening Shovel: Koutoulou's Shovel
Imposing R'Unique Hammer: R'Unique Hammer
Fearsome Mace Tmosfer: Mace Tmosfer
Imposing Outar Hammer: Outar Hammer
Powerful Pospodrol Hammer: Pospodrol Hammer
Royal Gobball Horn Bow: Gobball Horn Bow
I Kea Bow, New Model: I Kea Bow, Standard Model
Pure Crystal Bow: Crystal Bow
Ultra-powerful King of Borins Bow: King of Borins Bow
Imposing Clergy Wand: Clergy Wand
Essential Inacleft Stick: Inacleft Stick
Excellent Iron Wand: Iron Wand
Tremendous Dakn Staff: Dakn Staff
Omniscient Crystal Staff-Ball: Crystal Staff-Ball
Excellent Kings' Staff: Kings' Staff
King Playa's Scepta: King Playa’s Scepta
Great Mechba Shovel: Mechba Shovel
Bloody Craft Knife: Craft Knife
Vampyre Ring: Vampire Ring
Vampyre Amulet: Vampire Amulet
Vampyre Belt: Vampire Belt
Vampyre Cape: Vampire Cape
Vampyre Boots: Vampire Boots
Vampyre Mask: Vampire Mask
Crow Cloak: Crobak Cloak
Royal Gobball Sword: Royal Gobball's Sword
Royal Gobball Ring: Royal Gobball's Ring
Royal Gobball Belt: Royal Gobball's Belt
Crow Helmet: Crobak Helmet
Novice Amulet: Intrepid Amulet
Novice Ring: Intrepid Ring
Novice Boots: Intrepid Boots
Novice Shield: Intrepid Shield
Novice Belt: Intrepid Belt
Novice Cloak: Intrepid Cloak
Novice Hat: Intrepid Hat
Powerful Pushn Shovel: Pushn Shovel
Karotz' Ring: Kawotz's Ring
Karotz' Amulet: Kawotz's Amulet
Karotz' Boots: Kawotz's Boots
Karotz' Staff: Kawotz's Staff
Captain Pirate's Hat: Pirate Captain’s Hat
Captain Pirate's Wedding Ring: Pirate Captain’s Wedding Ring
KOs' Belt: KOs’ Belt
KOs' Amulet: KOs’ Amulet
Powerful Stek Knife: Stek Knife
Powerful Rowler Blade: Rowler Blade
KOs' Boots: KOs’ Boots
Imposing Woukuis Shovel: Woukuis Shovel
Crowcape: Crobacape
Powerful Aj Taye Mace: Aj Taye Mace
Royal Gobball Cape: Royal Gobball's Cape
Houvette's Traumatic Wand: Houvette's Wand
Tanukoui San Collar: Tanukouï San Collar
Caracape New: Caracape
Mehlodra Mask: Celestial Gobball Belt
Etorik Belt: Celestial Gobball Amulet
Cally Bangle: Celestial Gobball Boots
Swyndelsash: Celestial Gobball Ring
